▤▤▤▤▤▤▤▤▤▤▤▤▤▤▤▤▤▤▤▤▤▤▤▤▤▤▤▤▤▤▤▤▤▤▤▤▤▤▤▤▤▤▤▤▤▤▤▤▤▤▤▤▤▤▤▤▤▤▤▤▤▤▤▤▤▤▤▤▤▤▤▤▤▤▤▤▤▤▤▤▤▤▤▤▤▤▤▤▤▤▤▤▤▤▤▤▤▤▤▤
▤ ▤   ▤ ▤ ▤ ▤         ▤   ▤       ▤ ▤   ▤ ▤ ▤ ▤ ▤ ▤ ▤ ▤ ▤ ▤             ▤ ▤   ▤   ▤   ▤         ▤  ▤
▤▤▤ ▤ ▤▤▤ ▤▤▤ ▤▤▤ ▤ ▤▤▤ ▤ ▤ ▤▤▤▤▤▤▤▤▤▤▤▤▤ ▤▤▤▤▤ ▤ ▤ ▤ ▤ ▤ ▤▤▤▤▤ ▤▤▤▤▤ ▤ ▤▤▤ ▤▤▤▤▤▤▤ ▤▤▤ ▤ ▤▤▤ ▤▤▤▤▤▤
▤     ▤         ▤   ▤       ▤ ▤ ▤     ▤ ▤   ▤ ▤       ▤     ▤   ▤         ▤   ▤ ▤ ▤ ▤   ▤ ▤     ▤  ▤
▤▤▤ ▤▤▤▤▤▤▤ ▤▤▤ ▤▤▤▤▤ ▤▤▤ ▤▤▤▤▤ ▤▤▤▤▤▤▤ ▤ ▤ ▤ ▤▤▤ ▤▤▤ ▤ ▤ ▤ ▤▤▤ ▤ ▤▤▤ ▤▤▤ ▤ ▤ ▤▤▤ ▤▤▤ ▤ ▤▤▤▤▤ ▤▤▤▤▤▤
▤ ▤     ▤ ▤ ▤       ▤   ▤ ▤ ▤     ▤ ▤ ▤ ▤         ▤ ▤ ▤   ▤ ▤ ▤ ▤ ▤ ▤   ▤ ▤ ▤ ▤ ▤ ▤   ▤   ▤ ▤   ▤ ▤▤
▤ ▤▤▤ ▤▤▤ ▤ ▤ ▤▤▤▤▤ ▤▤▤ ▤ ▤ ▤ ▤ ▤ ▤▤▤▤▤ ▤▤▤▤▤▤▤▤▤▤▤▤▤▤▤▤▤ ▤▤▤▤▤▤▤▤▤ ▤ ▤ ▤▤▤ ▤ ▤ ▤▤▤ ▤▤▤▤▤ ▤▤▤ ▤▤▤▤▤▤
▤     ▤     ▤                     ▤     ▤   ▤ ▤ ▤ ▤ ▤     ▤       ▤       ▤ ▤     ▤ ▤   ▤   ▤      ▤
▤▤▤ ▤▤▤▤▤▤▤ ▤▤▤ ▤▤▤ ▤▤▤▤▤ ▤▤▤ ▤▤▤▤▤ ▤ ▤▤▤ ▤▤▤ ▤ ▤▤▤▤▤ ▤ ▤ ▤ ▤▤▤▤▤▤▤ ▤ ▤▤▤▤▤ ▤▤▤▤▤ ▤ ▤ ▤▤▤▤▤▤▤ ▤▤▤▤▤▤
▤   ▤   ▤   ▤   ▤ ▤ ▤   ▤ ▤ ▤ ▤   ▤ ▤ ▤   ▤   ▤ ▤   ▤   ▤   ▤ ▤           ▤   ▤ ▤ ▤ ▤   ▤ ▤ ▤      ▤
▤▤▤ ▤▤▤▤▤ ▤▤▤▤▤▤▤▤▤ ▤ ▤▤▤▤▤▤▤▤▤▤▤ ▤▤▤ ▤ ▤▤▤ ▤▤▤▤▤ ▤ ▤▤▤▤▤▤▤ ▤▤▤ ▤ ▤ ▤ ▤ ▤▤▤ ▤▤▤ ▤ ▤▤▤ ▤ ▤ ▤▤▤ ▤▤▤ ▤▤
▤ ▤ ▤ ▤   ▤ ▤ ▤ ▤   ▤     ▤   ▤ ▤ ▤ ▤   ▤ ▤     ▤ ▤           ▤ ▤         ▤ ▤   ▤ ▤   ▤ ▤ ▤ ▤   ▤  ▤
▤▤▤▤▤☺▤▤▤▤▤ ▤ ▤▤▤▤▤ ▤▤▤ ▤ ▤▤▤ ▤▤▤▤▤▤▤ ▤▤▤▤▤▤▤ ▤▤▤ ▤▤▤ ▤▤▤▤▤▤▤ ▤ ▤ ▤▤▤ ▤ ▤▤▤▤▤ ▤ ▤ ▤▤▤▤▤ ▤▤▤▤▤ ▤ ▤ ▤▤
▤   ▤ ▤ ▤ ▤ ▤   ▤ ▤ ▤ ▤ ▤ ▤ ▤ ▤ ▤ ▤   ▤     ▤ ▤   ▤ ▤ ▤ ▤   ▤   ▤     ▤       ▤ ▤ ▤   ▤   ▤ ▤ ▤    ▤
▤▤▤▤▤▤▤ ▤ ▤▤▤▤▤▤▤▤▤ ▤▤▤▤▤▤▤▤▤▤▤▤▤▤▤▤▤▤▤ ▤ ▤▤▤ ▤▤▤▤▤ ▤▤▤ ▤▤▤ ▤▤▤▤▤▤▤ ▤▤▤ ▤ ▤ ▤▤▤ ▤▤▤ ▤ ▤ ▤▤▤▤▤ ▤▤▤▤▤▤
▤   ▤       ▤     ▤ ▤ ▤   ▤ ▤   ▤ ▤   ▤       ▤   ▤ ▤ ▤   ▤ ▤   ▤   ▤ ▤   ▤ ▤ ▤   ▤   ▤ ▤   ▤     ▤▤
▤▤▤ ▤ ▤ ▤ ▤▤▤▤▤ ▤ ▤▤▤ ▤▤▤ ▤▤▤▤▤▤▤ ▤▤▤▤▤ ▤▤▤▤▤▤▤▤▤▤▤▤▤▤▤▤▤▤▤ ▤▤▤▤▤ ▤▤▤▤▤ ▤▤▤▤▤▤▤▤▤ ▤▤▤ ▤ ▤ ▤ ▤ ▤ ▤ ▤▤
▤ ▤ ▤     ▤ ▤ ▤ ▤ ▤ ▤               ▤ ▤         ▤ ▤ ▤ ▤ ▤ ▤   ▤ ▤ ▤ ▤ ▤     ▤ ▤   ▤ ▤ ▤ ▤   ▤ ▤   ▤▤
▤ ▤ ▤ ▤ ▤ ▤▤▤ ▤ ▤▤▤ ▤▤▤▤▤▤▤▤▤▤▤▤▤▤▤▤▤ ▤▤▤▤▤▤▤ ▤ ▤▤▤▤▤ ▤▤▤▤▤ ▤▤▤▤▤▤▤▤▤▤▤▤▤▤▤ ▤ ▤▤▤ ▤ ▤ ▤▤▤ ▤ ▤ ▤ ▤ ▤▤
▤ ▤   ▤           ▤ ▤   ▤   ▤   ▤     ▤ ▤ ▤ ▤   ▤ ▤ ▤ ▤ ▤ ▤ ▤ ▤ ▤ ▤       ▤ ▤ ▤ ▤ ▤   ▤ ▤          ▤
▤▤▤ ▤▤▤▤▤ ▤▤▤ ▤ ▤ ▤▤▤ ▤▤▤▤▤ ▤ ▤▤▤ ▤ ▤▤▤ ▤ ▤ ▤ ▤ ▤ ▤ ▤ ▤ ▤▤▤ ▤▤▤▤▤ ▤▤▤ ▤ ▤ ▤▤▤ ▤ ▤ ▤ ▤ ▤ ▤ ▤▤▤ ▤ ▤▤▤▤
▤   ▤           ▤   ▤ ▤ ▤ ▤           ▤ ▤   ▤ ▤   ▤   ▤ ▤ ▤   ▤ ▤ ▤ ▤ ▤ ▤       ▤   ▤ ▤ ▤ ▤ ▤      ▤
▤ ▤ ▤▤▤ ▤▤▤ ▤▤▤ ▤▤▤▤▤ ▤ ▤▤▤ ▤▤▤▤▤▤▤▤▤ ▤▤▤ ▤ ▤ ▤ ▤ ▤ ▤▤▤ ▤ ▤ ▤ ▤▤▤▤▤▤▤ ▤ ▤▤▤▤▤▤▤ ▤▤▤ ▤▤▤▤▤▤▤▤▤ ▤ ▤▤▤▤
▤ ▤ ▤   ▤   ▤   ▤ ▤   ▤ ▤       ▤   ▤     ▤     ▤   ▤ ▤ ▤ ▤ ▤   ▤   ▤     ▤     ▤   ▤   ▤   ▤     ▤▤
▤ ▤▤▤▤▤▤▤▤▤ ▤▤▤ ▤ ▤▤▤ ▤▤▤ ▤▤▤ ▤▤▤ ▤▤▤ ▤ ▤▤▤ ▤ ▤ ▤ ▤▤▤▤▤ ▤ ▤▤▤▤▤▤▤ ▤ ▤ ▤▤▤ ▤▤▤ ▤ ▤▤▤▤▤▤▤ ▤▤▤ ▤ ▤ ▤▤▤▤
▤ ▤ ▤   ▤ ▤ ▤ ▤ ▤   ▤           ▤   ▤     ▤   ▤   ▤   ▤ ▤ ▤   ▤ ▤ ▤       ▤   ▤ ▤ ▤ ▤   ▤ ▤ ▤      ▤
▤▤▤▤▤ ▤▤▤▤▤ ▤▤▤ ▤▤▤▤▤ ▤▤▤ ▤ ▤ ▤ ▤▤▤▤▤▤▤ ▤▤▤ ▤ ▤ ▤▤▤ ▤▤▤ ▤ ▤ ▤ ▤▤▤ ▤ ▤▤▤▤▤ ▤ ▤▤▤▤▤ ▤ ▤ ▤ ▤▤▤▤▤ ▤ ▤ ▤▤
▤   ▤ ▤   ▤ ▤   ▤ ▤       ▤ ▤ ▤         ▤ ▤   ▤     ▤   ▤   ▤     ▤       ▤ ▤ ▤   ▤   ▤   ▤ ▤ ▤    ▤
▤▤▤▤▤ ▤ ▤ ▤ ▤ ▤▤▤▤▤ ▤▤▤▤▤▤▤▤▤▤▤ ▤▤▤ ▤ ▤▤▤ ▤ ▤▤▤ ▤ ▤▤▤ ▤▤▤▤▤ ▤ ▤ ▤▤▤▤▤▤▤▤▤ ▤ ▤ ▤▤▤ ▤ ▤▤▤ ▤ ▤▤▤▤▤▤▤▤▤▤
▤     ▤ ▤     ▤     ▤   ▤ ▤ ▤     ▤         ▤   ▤   ▤ ▤     ▤ ▤ ▤   ▤   ▤   ▤   ▤     ▤   ▤     ▤  ▤
▤ ▤▤▤ ▤▤▤ ▤ ▤▤▤ ▤▤▤▤▤ ▤▤▤ ▤▤▤▤▤ ▤ ▤ ▤ ▤ ▤▤▤▤▤▤▤▤▤ ▤ ▤▤▤▤▤▤▤▤▤ ▤▤▤▤▤▤▤ ▤ ▤▤▤ ▤ ▤▤▤ ▤ ▤▤▤▤▤ ▤▤▤▤▤▤▤ ▤▤
▤     ▤ ▤       ▤ ▤ ▤     ▤       ▤ ▤ ▤ ▤ ▤ ▤ ▤     ▤   ▤ ▤       ▤       ▤ ▤ ▤ ▤ ▤ ▤   ▤       ▤  ▤
▤ ▤▤▤▤▤ ▤▤▤ ▤ ▤ ▤ ▤ ▤▤▤ ▤▤▤ ▤ ▤ ▤ ▤ ▤▤▤▤▤▤▤▤▤▤▤ ▤▤▤ ▤▤▤ ▤ ▤ ▤ ▤ ▤▤▤▤▤▤▤▤▤▤▤ ▤ ▤ ▤▤▤ ▤ ▤ ▤▤▤▤▤▤▤▤▤ ▤▤
▤ ▤ ▤ ▤ ▤   ▤       ▤   ▤ ▤           ▤ ▤   ▤ ▤ ▤   ▤       ▤ ▤     ▤       ▤     ▤ ▤ ▤ ▤ ▤ ▤   ▤  ▤
▤▤▤▤▤▤▤ ▤▤▤▤▤▤▤▤▤ ▤▤▤▤▤ ▤ ▤ ▤▤▤▤▤ ▤▤▤ ▤ ▤▤▤▤▤▤▤ ▤ ▤ ▤ ▤ ▤ ▤▤▤ ▤ ▤▤▤▤▤ ▤ ▤▤▤▤▤ ▤ ▤▤▤▤▤ ▤▤▤ ▤ ▤▤▤▤▤▤▤▤
▤       ▤   ▤ ▤ ▤ ▤           ▤     ▤     ▤ ▤                 ▤ ▤   ▤     ▤ ▤ ▤ ▤ ▤ ▤ ▤ ▤ ▤   ▤ ▤ ▤▤
▤▤▤▤▤▤▤ ▤ ▤▤▤ ▤ ▤▤▤ ▤▤▤▤▤▤▤ ▤ ▤ ▤ ▤ ▤ ▤▤▤ ▤▤▤▤▤▤▤▤▤▤▤▤▤▤▤▤▤▤▤ ▤ ▤▤▤ ▤ ▤▤▤ ▤▤▤▤▤ ▤ ▤ ▤▤▤▤▤ ▤▤▤▤▤▤▤ ▤▤
▤ ▤         ▤     ▤ ▤         ▤     ▤ ▤   ▤ ▤       ▤   ▤ ▤ ▤       ▤ ▤ ▤ ▤               ▤   ▤ ▤ ▤▤
▤▤▤▤▤ ▤ ▤ ▤▤▤ ▤▤▤▤▤ ▤▤▤ ▤ ▤▤▤▤▤ ▤▤▤▤▤ ▤ ▤▤▤▤▤ ▤▤▤▤▤▤▤▤▤ ▤ ▤ ▤ ▤▤▤ ▤ ▤ ▤ ▤▤▤ ▤▤▤▤▤▤▤▤▤▤▤▤▤ ▤ ▤▤▤ ▤▤▤▤
▤ ▤     ▤ ▤     ▤ ▤         ▤         ▤ ▤ ▤         ▤     ▤ ▤ ▤ ▤ ▤ ▤ ▤     ▤ ▤ ▤ ▤     ▤     ▤ ▤  ▤
▤ ▤ ▤ ▤ ▤▤▤▤▤ ▤▤▤▤▤ ▤ ▤ ▤ ▤ ▤▤▤▤▤ ▤ ▤▤▤▤▤ ▤▤▤ ▤▤▤▤▤▤▤ ▤ ▤ ▤▤▤ ▤ ▤ ▤ ▤▤▤ ▤ ▤▤▤ ▤▤▤▤▤▤▤▤▤ ▤ ▤▤▤▤▤▤▤▤▤▤
▤ ▤ ▤ ▤   ▤     ▤ ▤ ▤ ▤   ▤ ▤       ▤ ▤     ▤ ▤ ▤ ▤   ▤   ▤     ▤ ▤   ▤ ▤ ▤ ▤ ▤     ▤     ▤     ▤  ▤
▤ ▤▤▤ ▤ ▤ ▤ ▤ ▤ ▤▤▤▤▤▤▤▤▤ ▤▤▤ ▤▤▤▤▤▤▤▤▤ ▤ ▤▤▤▤▤▤▤▤▤▤▤▤▤▤▤ ▤ ▤▤▤▤▤ ▤▤▤ ▤▤▤ ▤▤▤▤▤ ▤▤▤ ▤▤▤▤▤ ▤▤▤▤▤ ▤▤▤▤
▤     ▤ ▤       ▤ ▤ ▤   ▤   ▤       ▤   ▤     ▤ ▤     ▤ ▤ ▤       ▤ ▤       ▤     ▤   ▤ ▤         ▤▤
▤ ▤ ▤▤▤▤▤ ▤▤▤▤▤ ▤ ▤▤▤▤▤ ▤▤▤ ▤ ▤ ▤▤▤▤▤▤▤ ▤ ▤ ▤▤▤ ▤▤▤ ▤ ▤ ▤ ▤▤▤ ▤▤▤ ▤ ▤ ▤ ▤▤▤ ▤ ▤ ▤▤▤ ▤ ▤ ▤ ▤ ▤ ▤ ▤ ▤▤
▤ ▤ ▤       ▤ ▤   ▤ ▤   ▤ ▤   ▤ ▤ ▤ ▤ ▤   ▤   ▤ ▤   ▤ ▤ ▤   ▤     ▤ ▤ ▤ ▤   ▤ ▤ ▤ ▤ ▤ ▤ ▤ ▤ ▤ ▤    ▤
▤▤▤ ▤ ▤ ▤▤▤▤▤ ▤▤▤ ▤ ▤ ▤ ▤ ▤ ▤ ▤ ▤ ▤▤▤▤▤ ▤ ▤ ▤ ▤▤▤ ▤ ▤▤▤ ▤ ▤ ▤▤▤▤▤▤▤▤▤ ▤ ▤ ▤▤▤ ▤ ▤▤▤ ▤ ▤▤▤▤▤ ▤▤▤▤▤ ▤▤
▤ ▤   ▤   ▤       ▤ ▤   ▤   ▤ ▤       ▤       ▤     ▤ ▤ ▤ ▤ ▤ ▤   ▤ ▤       ▤ ▤   ▤ ▤ ▤   ▤ ▤ ▤ ▤ ▤▤
▤ ▤▤▤ ▤ ▤▤▤ ▤ ▤ ▤▤▤▤▤ ▤ ▤▤▤ ▤ ▤ ▤▤▤▤▤ ▤▤▤ ▤▤▤ ▤ ▤ ▤▤▤▤▤ ▤ ▤▤▤▤▤ ▤ ▤ ▤ ▤ ▤ ▤▤▤▤▤ ▤▤▤▤▤▤▤▤▤▤▤ ▤ ▤ ▤ ▤▤
▤ ▤ ▤ ▤   ▤ ▤       ▤   ▤ ▤         ▤ ▤   ▤ ▤ ▤   ▤         ▤ ▤   ▤ ▤ ▤     ▤   ▤       ▤ ▤        ▤
▤ ▤ ▤ ▤▤▤▤▤ ▤ ▤ ▤ ▤ ▤▤▤▤▤▤▤▤▤ ▤▤▤ ▤▤▤ ▤ ▤▤▤▤▤ ▤▤▤▤▤▤▤ ▤▤▤ ▤▤▤ ▤ ▤▤▤ ▤ ▤▤▤▤▤ ▤▤▤ ▤ ▤▤▤▤▤ ▤ ▤▤▤▤▤ ▤ ▤▤
▤ ▤   ▤     ▤ ▤   ▤   ▤ ▤   ▤   ▤   ▤     ▤   ▤ ▤ ▤ ▤     ▤       ▤ ▤       ▤   ▤ ▤       ▤   ▤ ▤ ▤▤
▤▤▤ ▤ ▤▤▤ ▤ ▤▤▤ ▤ ▤▤▤ ▤▤▤ ▤ ▤ ▤▤▤ ▤▤▤ ▤▤▤▤▤▤▤ ▤▤▤ ▤▤▤▤▤▤▤▤▤▤▤▤▤ ▤▤▤▤▤▤▤▤▤ ▤▤▤▤▤ ▤▤▤ ▤▤▤▤▤ ▤▤▤▤▤▤▤▤▤▤
▤ ▤         ▤               ▤     ▤ ▤   ▤   ▤   ▤ ▤ ▤ ▤   ▤     ▤ ▤               ▤ ▤   ▤ ▤     ▤  ▤
▤ ▤ ▤ ▤▤▤▤▤▤▤ ▤▤▤ ▤▤▤ ▤▤▤▤▤ ▤ ▤▤▤▤▤▤▤▤▤ ▤ ▤ ▤ ▤ ▤ ▤▤▤▤▤▤▤▤▤ ▤▤▤▤▤ ▤▤▤ ▤ ▤ ▤▤▤ ▤ ▤ ▤▤▤▤▤ ▤ ▤▤▤ ▤▤▤ ▤▤
▤ ▤       ▤   ▤         ▤ ▤         ▤ ▤ ▤ ▤ ▤   ▤       ▤   ▤ ▤ ▤             ▤ ▤   ▤   ▤   ▤ ▤    ▤
▤▤▤▤▤ ▤▤▤▤▤▤▤▤▤▤▤▤▤▤▤▤▤ ▤▤▤▤▤▤▤ ▤ ▤ ▤▤▤▤▤▤▤▤▤ ▤ ▤ ▤ ▤ ▤▤▤ ▤▤▤▤▤▤▤▤▤▤▤▤▤▤▤▤▤ ▤ ▤ ▤▤▤▤▤ ▤▤▤ ▤▤▤▤▤ ▤▤▤▤
▤ ▤ ▤ ▤ ▤     ▤   ▤ ▤  P▤ ▤   ▤       ▤       ▤ ▤     ▤ ▤   ▤         ▤ ▤   ▤       ▤     ▤   ▤ ▤  ▤
▤▤▤▤▤▤▤▤▤ ▤ ▤ ▤ ▤ ▤▤▤ ▤▤▤▤▤▤▤ ▤▤▤ ▤ ▤▤▤▤▤▤▤▤▤▤▤▤▤▤▤▤▤▤▤▤▤ ▤▤▤▤▤▤▤▤▤ ▤ ▤ ▤ ▤ ▤▤▤ ▤▤▤▤▤▤▤ ▤ ▤ ▤▤▤ ▤ ▤▤
▤ ▤ ▤ ▤ ▤ ▤     ▤     ▤           ▤   ▤ ▤ ▤     ▤   ▤ ▤     ▤ ▤     ▤   ▤ ▤ ▤ ▤   ▤ ▤ ▤ ▤   ▤ ▤   ▤▤
▤ ▤ ▤ ▤ ▤▤▤▤▤ ▤ ▤▤▤ ▤ ▤▤▤ ▤ ▤ ▤ ▤▤▤ ▤▤▤ ▤ ▤ ▤ ▤ ▤ ▤▤▤▤▤ ▤▤▤ ▤ ▤ ▤▤▤▤▤▤▤ ▤▤▤▤▤▤▤ ▤ ▤ ▤ ▤ ▤ ▤▤▤▤▤ ▤ ▤▤
▤ ▤     ▤     ▤ ▤   ▤   ▤       ▤ ▤ ▤ ▤         ▤ ▤ ▤   ▤   ▤ ▤                   ▤   ▤ ▤          ▤
▤ ▤▤▤ ▤ ▤ ▤ ▤ ▤ ▤ ▤▤▤ ▤ ▤▤▤ ▤ ▤ ▤ ▤▤▤ ▤ ▤ ▤ ▤▤▤▤▤ ▤▤▤▤▤ ▤▤▤ ▤▤▤▤▤▤▤▤▤ ▤▤▤▤▤▤▤ ▤▤▤ ▤ ▤ ▤▤▤ ▤▤▤ ▤ ▤ ▤▤
▤     ▤ ▤ ▤           ▤ ▤ ▤         ▤   ▤ ▤ ▤ ▤ ▤     ▤     ▤   ▤       ▤ ▤ ▤ ▤ ▤ ▤   ▤       ▤ ▤ ▤▤
▤ ▤▤▤ ▤▤▤▤▤▤▤ ▤ ▤ ▤▤▤ ▤▤▤ ▤ ▤▤▤▤▤▤▤ ▤ ▤▤▤ ▤▤▤ ▤ ▤▤▤ ▤▤▤▤▤▤▤▤▤▤▤▤▤▤▤ ▤ ▤ ▤ ▤▤▤▤▤▤▤▤▤ ▤ ▤▤▤ ▤▤▤ ▤▤▤ ▤▤
▤ ▤ ▤     ▤             ▤   ▤     ▤ ▤ ▤     ▤ ▤   ▤ ▤ ▤ ▤   ▤ ▤ ▤ ▤ ▤ ▤ ▤ ▤ ▤       ▤ ▤     ▤ ▤   ▤▤
▤▤▤ ▤▤▤ ▤ ▤ ▤▤▤ ▤▤▤▤▤ ▤▤▤ ▤ ▤ ▤ ▤▤▤ ▤ ▤▤▤▤▤▤▤ ▤ ▤ ▤▤▤ ▤▤▤ ▤ ▤ ▤ ▤▤▤▤▤▤▤▤▤▤▤ ▤ ▤ ▤▤▤ ▤ ▤ ▤▤▤ ▤ ▤ ▤▤▤▤
▤   ▤ ▤ ▤     ▤ ▤ ▤           ▤ ▤ ▤ ▤ ▤   ▤     ▤ ▤   ▤ ▤     ▤ ▤     ▤ ▤ ▤ ▤ ▤   ▤     ▤     ▤   ▤▤
▤▤▤ ▤ ▤▤▤ ▤▤▤ ▤ ▤ ▤ ▤▤▤▤▤ ▤▤▤▤▤▤▤ ▤ ▤ ▤▤▤ ▤ ▤▤▤ ▤▤▤ ▤ ▤▤▤ ▤▤▤▤▤ ▤ ▤▤▤▤▤ ▤▤▤▤▤▤▤ ▤▤▤▤▤ ▤▤▤ ▤▤▤▤▤▤▤ ▤▤
▤ ▤ ▤ ▤     ▤ ▤ ▤ ▤ ▤ ▤       ▤ ▤     ▤ ▤   ▤ ▤     ▤     ▤   ▤ ▤ ▤   ▤ ▤   ▤ ▤     ▤ ▤ ▤     ▤    ▤
▤ ▤▤▤▤▤▤▤▤▤ ▤▤▤▤▤▤▤▤▤ ▤▤▤ ▤▤▤ ▤▤▤▤▤▤▤▤▤▤▤▤▤▤▤ ▤ ▤▤▤ ▤▤▤ ▤▤▤▤▤▤▤▤▤ ▤ ▤▤▤▤▤ ▤▤▤ ▤▤▤ ▤ ▤ ▤ ▤▤▤ ▤ ▤▤▤▤▤▤
▤     ▤     ▤ ▤     ▤   ▤ ▤       ▤       ▤   ▤           ▤   ▤ ▤       ▤       ▤ ▤ ▤ ▤   ▤       ▤▤
▤▤▤▤▤▤▤ ▤▤▤ ▤▤▤▤▤ ▤▤▤▤▤ ▤▤▤▤▤ ▤▤▤ ▤ ▤ ▤ ▤▤▤▤▤▤▤▤▤ ▤ ▤▤▤▤▤ ▤▤▤▤▤▤▤ ▤▤▤ ▤ ▤ ▤ ▤▤▤ ▤ ▤ ▤▤▤▤▤▤▤▤▤▤▤▤▤▤▤▤
▤   ▤                 ▤ ▤ ▤ ▤   ▤ ▤   ▤   ▤     ▤ ▤ ▤ ▤       ▤   ▤ ▤ ▤   ▤ ▤           ▤          ▤
▤▤▤▤▤ ▤▤▤▤▤▤▤▤▤▤▤▤▤▤▤ ▤▤▤ ▤ ▤ ▤ ▤ ▤ ▤ ▤ ▤▤▤▤▤ ▤▤▤ ▤ ▤▤▤ ▤ ▤ ▤ ▤▤▤ ▤ ▤▤▤ ▤ ▤▤▤▤▤ ▤ ▤▤▤▤▤ ▤ ▤▤▤▤▤▤▤ ▤▤
▤ ▤ ▤ ▤ ▤       ▤ ▤ ▤   ▤   ▤ ▤ ▤       ▤   ▤ ▤ ▤       ▤ ▤   ▤ ▤     ▤ ▤     ▤ ▤ ▤ ▤       ▤ ▤   ▤▤
▤ ▤ ▤▤▤ ▤▤▤▤▤ ▤ ▤▤▤ ▤ ▤▤▤▤▤ ▤ ▤ ▤▤▤▤▤ ▤ ▤▤▤▤▤▤▤ ▤▤▤ ▤▤▤▤▤▤▤▤▤ ▤▤▤ ▤▤▤ ▤▤▤ ▤ ▤ ▤▤▤▤▤▤▤ ▤▤▤▤▤ ▤▤▤▤▤ ▤▤
▤     ▤ ▤ ▤   ▤ ▤         ▤             ▤ ▤         ▤ ▤ ▤     ▤ ▤   ▤       ▤ ▤ ▤   ▤ ▤ ▤ ▤ ▤   ▤ ▤▤
▤▤▤▤▤ ▤▤▤▤▤ ▤ ▤▤▤ ▤ ▤▤▤▤▤▤▤▤▤▤▤▤▤ ▤ ▤ ▤ ▤ ▤▤▤ ▤ ▤ ▤▤▤☺▤ ▤ ▤▤▤▤▤ ▤ ▤ ▤ ▤ ▤▤▤▤▤▤▤ ▤▤▤▤▤▤▤▤▤ ▤▤▤▤▤ ▤ ▤▤
▤ ▤ ▤ ▤ ▤ ▤         ▤ ▤   ▤ ▤       ▤           ▤ ▤       ▤ ▤   ▤ ▤         ▤   ▤ ▤ ▤ ▤ ▤   ▤ ▤    ▤
▤ ▤▤▤ ▤ ▤ ▤ ▤▤▤▤▤ ▤▤▤▤▤▤▤▤▤ ▤ ▤▤▤ ▤▤▤▤▤ ▤ ▤ ▤▤▤▤▤ ▤ ▤▤▤▤▤ ▤ ▤▤▤▤▤ ▤ ▤ ▤ ▤ ▤ ▤ ▤▤▤▤▤ ▤ ▤▤▤▤▤▤▤▤▤ ▤ ▤▤
▤     ▤   ▤ ▤   ▤ ▤ ▤ ▤     ▤           ▤ ▤ ▤ ▤ ▤ ▤ ▤ ▤   ▤         ▤ ▤ ▤ ▤ ▤     ▤       ▤ ▤ ▤ ▤ ▤▤
▤▤▤ ▤ ▤▤▤ ▤ ▤ ▤▤▤ ▤ ▤ ▤ ▤ ▤▤▤ ▤▤▤▤▤ ▤▤▤▤▤ ▤ ▤ ▤▤▤ ▤ ▤ ▤▤▤ ▤▤▤ ▤▤▤▤▤▤▤▤▤ ▤ ▤ ▤▤▤ ▤▤▤▤▤ ▤▤▤ ▤▤▤▤▤ ▤▤▤▤
▤     ▤   ▤ ▤ ▤ ▤ ▤   ▤   ▤   ▤ ▤ ▤ ▤   ▤   ▤ ▤ ▤   ▤     ▤ ▤     ▤ ▤       ▤ ▤         ▤     ▤ ▤ ▤▤
▤ ▤ ▤ ▤▤▤▤▤▤▤ ▤ ▤ ▤ ▤▤▤ ▤ ▤▤▤ ▤▤▤ ▤ ▤▤▤☺▤▤▤▤▤ ▤▤▤▤▤▤▤▤▤▤▤ ▤▤▤▤▤ ▤▤▤▤▤▤▤▤▤ ▤▤▤▤▤ ▤ ▤ ▤ ▤ ▤ ▤ ▤▤▤▤▤▤▤▤
▤   ▤ ▤   ▤ ▤ ▤   ▤ ▤                 ▤ ▤         ▤       ▤ ▤ ▤   ▤ ▤ ▤ ▤ ▤ ▤   ▤ ▤           ▤   ▤▤
▤▤▤ ▤ ▤▤▤▤▤▤▤ ▤ ▤ ▤ ▤ ▤▤▤▤▤▤▤ ▤ ▤ ▤▤▤ ▤ ▤ ▤▤▤▤▤ ▤ ▤▤▤▤▤▤▤ ▤▤▤ ▤▤▤ ▤ ▤▤▤▤▤▤▤ ▤▤▤▤▤▤▤ ▤ ▤ ▤▤▤ ▤▤▤▤▤ ▤▤
▤     ▤     ▤ ▤   ▤ ▤   ▤   ▤   ▤ ▤ ▤         ▤ ▤ ▤ ▤       ▤   ▤ ▤         ▤           ▤ ▤ ▤ ▤    ▤
▤▤▤▤▤ ▤▤▤▤▤▤▤▤▤▤▤▤▤▤▤▤▤ ▤▤▤▤▤▤▤▤▤ ▤▤▤▤▤▤▤ ▤▤▤▤▤ ▤▤▤▤▤ ▤ ▤ ▤ ▤▤▤▤▤▤▤ ▤ ▤▤▤▤▤ ▤▤▤ ▤▤▤ ▤ ▤ ▤▤▤▤▤ ▤ ▤ ▤▤
▤   ▤ ▤ ▤     ▤ ▤ ▤     ▤ ▤ ▤     ▤       ▤   ▤ ▤     ▤ ▤   ▤   ▤         ▤ ▤ ▤ ▤ ▤ ▤ ▤ ▤       ▤  ▤
▤ ▤ ▤▤▤ ▤ ▤▤▤▤▤▤▤▤▤▤▤ ▤▤▤▤▤ ▤▤▤▤▤ ▤▤▤ ▤▤▤ ▤ ▤▤▤▤▤▤▤▤▤ ▤▤▤▤▤ ▤▤▤ ▤▤▤▤▤▤▤▤▤ ▤▤▤ ▤▤▤▤▤ ▤▤▤ ▤ ▤▤▤ ▤ ▤ ▤▤
▤ ▤       ▤ ▤   ▤     ▤         ▤ ▤   ▤ ▤ ▤ ▤   ▤     ▤ ▤       ▤   ▤ ▤ ▤     ▤ ▤ ▤ ▤ ▤     ▤ ▤ ▤ ▤▤
▤▤▤▤▤▤▤▤▤▤▤▤▤▤▤ ▤ ▤▤▤▤▤ ▤ ▤ ▤▤▤▤▤▤▤▤▤ ▤ ▤▤▤ ▤ ▤ ▤▤▤ ▤ ▤▤▤▤▤ ▤ ▤ ▤ ▤▤▤ ▤▤▤▤▤▤▤ ▤▤▤ ▤ ▤▤▤▤▤▤▤▤▤ ▤ ▤ ▤▤
▤         ▤   ▤ ▤   ▤ ▤   ▤ ▤ ▤   ▤ ▤     ▤   ▤ ▤ ▤ ▤ ▤ ▤   ▤   ▤ ▤ ▤ ▤ ▤ ▤ ▤ ▤ ▤ ▤ ▤ ▤ ▤     ▤ ▤  ▤
▤▤▤▤▤▤▤▤▤ ▤▤▤▤▤▤▤ ▤▤▤▤▤ ▤ ▤▤▤▤▤ ▤▤▤ ▤ ▤ ▤▤▤ ▤▤▤ ▤▤▤▤▤ ▤▤▤▤▤ ▤▤▤ ▤ ▤ ▤▤▤ ▤▤▤ ▤ ▤ ▤ ▤ ▤▤▤▤▤ ▤▤▤ ▤ ▤▤▤▤
▤   ▤ ▤   ▤   ▤ ▤     ▤     ▤         ▤       ▤     ▤ ▤     ▤       ▤ ▤ ▤       ▤ ▤   ▤ ▤ ▤ ▤   ▤ ▤▤
▤ ▤ ▤▤▤ ▤▤▤▤▤ ▤ ▤▤▤ ▤▤▤ ▤▤▤ ▤▤▤ ▤ ▤ ▤ ▤ ▤▤▤ ▤▤▤ ▤ ▤ ▤▤▤▤▤▤▤▤▤ ▤▤▤▤▤▤▤ ▤ ▤ ▤ ▤ ▤▤▤▤▤ ▤ ▤▤▤ ▤▤▤ ▤▤▤▤▤▤
▤         ▤   ▤     ▤   ▤ ▤ ▤         ▤ ▤ ▤     ▤ ▤   ▤     ▤ ▤ ▤                                 ▤▤
▤▤▤▤▤▤▤▤▤ ▤▤▤ ▤ ▤▤▤ ▤ ▤ ▤▤▤ ▤ ▤▤▤ ▤▤▤▤▤ ▤▤▤ ▤ ▤ ▤ ▤ ▤▤▤ ▤ ▤▤▤ ▤ ▤▤▤▤▤ ▤ ▤▤▤▤▤ ▤▤▤ ▤▤▤▤▤ ▤▤▤ ▤ ▤ ▤ ▤▤
▤▤▤▤▤▤▤▤▤▤▤▤▤▤▤▤▤▤▤▤▤▤▤▤▤▤▤▤▤▤▤▤▤▤▤▤▤▤▤▤▤▤▤▤▤▤▤▤▤▤▤▤▤▤▤▤▤▤▤▤▤▤▤▤▤▤▤▤▤▤▤▤▤▤▤▤▤▤▤▤▤▤▤▤▤▤▤▤▤▤▤▤▤▤▤▤▤▤▤▤
