▤▤▤▤▤▤▤▤▤▤▤▤▤▤▤▤▤▤▤▤▤▤▤▤▤▤▤▤▤▤▤▤▤▤▤▤▤▤▤▤▤▤▤▤▤▤▤▤▤▤▤▤▤▤▤▤▤▤▤▤▤▤▤▤▤▤▤▤▤▤▤▤▤▤▤▤▤▤▤▤
▤♣            ▤▤             ▤                 ▤   ▤▤     ▤      ▤   ▤   ▤    ▤▤
▤   ▤▤▤▤                     ▤                           ▤▤                    ▤
▤   ▤▤▤▤           ☺                                      ▤                    ▤
▤                            ▤             ♣              ▤                    ▤
▤♣♣♣              P          ▤             ♣                                   ▤
▤♣♣♣♣    ▤▤▤▤▤▤▤▤            ▤                            ▤                    ▤
▤ ♣♣♣♣   ▤      ▤            ▤                            ▤                    ▤
▤  ♣     ▤      ▤            ▤                            ▤                    ▤
▤        ▤      ▤▤▤▤▤▤▤▤▤▤▤  ▤                            ▤                    ▤
▤    ♣   ▤                   ▤                            ▤                    ▤
▤        ▤                   ▤                            ▤                    ▤
▤        ▤▤▤▤▤▤▤▤▤▤▤▤▤▤▤▤▤▤▤▤▤                            ▤                    ▤
▤   ☺                        ▤                            ▤                    ▤
▤                  ♣         ▤                            ▤                    ▤
▤                            ▤                            ▤                    ▤
▤  ▤▤▤▤▤▤▤▤▤▤▤▤▤▤▤▤▤▤▤▤▤▤▤   ▤                            ▤                    ▤
▤  ▤                     ▤   ▤                            ▤                    ▤
▤  ▤                     ▤   ▤                            ▤                    ▤
▤  ▤                     ▤   ▤                            ▤▤▤▤▤▤▤▤▤▤▤▤▤▤▤▤▤▤▤▤ ▤
▤  ▤                     ▤▤▤▤▤                            ▤                    ▤
▤  ▤                         ▤                            ▤                    ▤
▤  ▤                         ▤                            ▤                    ▤
▤  ▤  ▤▤▤▤▤▤▤▤▤▤▤▤▤▤▤▤▤▤▤▤▤▤▤▤            ♣♣♣♣♣♣          ▤                    ▤
▤  ▤                         ▤             ♣♣♣♣           ▤                    ▤
▤  ▤                         ▤                            ▤                    ▤
▤  ▤                         ▤                            ▤                    ▤
▤  ▤                         ▤                            ▤                    ▤
▤                            ▤                            ▤                    ▤
▤▤▤▤▤▤▤▤▤▤▤▤▤▤▤▤▤▤▤▤▤▤▤▤▤▤▤▤▤▤▤▤▤▤▤▤▤▤▤▤▤▤▤▤▤▤▤▤▤▤▤▤▤▤▤▤▤▤▤▤▤▤▤▤▤▤▤▤▤▤▤▤▤▤▤▤▤▤▤▤
